NO ./textures/purplestone.xpm
WE ./textures/eagle.xpm
SO ./textures/mossy.xpm
EA ./textures/redbrick.xpm

F 19,168,5
C 66,135,245

1111111111111111111111111
1111111111010101111111111
        1000000000110000011111111
        101100000111000000S000001
        1001000000000000000000001
111111111011000001110000000000001
100000000011000001110111111111111
11110111111111011100000010001
11110111111111011101010010001
11000000110101011100000010001
10000000000000001100000010001
10000000100000001101010010001
11110111 1110101 101111010001
11111111 1111111 111111111111
