NO ./textures/purplestone.xpm
WE ./textures/eagle.xpm
SO ./textures/mossy.xpm
EA ./textures/redbrick.xpm

F 220,100,0



	C 214,30,0

1111
1001
10N1
1111
