********************************************************111111
********************************************************11000111111111
****************11111111111111111***********************11000000000001
****************100000011100000011111111111111111111111111000000000001
****************100000011100000000000000000000000000000000000000000001
****************100000000000000011111111111111111001111111111111011111
****************10000011011100001***************1001***********101
****************10000000000000001***************1001***********101111111111111111
****************10000110000001101***************1001***********100000000000000001
****************10000000000001101***********111110011111*******111111111111111101
****************10000111000000001***********100000000001**********************101
****************10000001000000001***********100000000001**********************101
****************10000001000000001111111111111000000000011111111111111111111111101
****************100000010000000000000000000000000W0000000000000000000000000000001
****************11111011111111111111111111111000000000011111111111111111111111101
********************101*********************100000000001**********************101
****************11111011111111111***********100000000001**********************101
****************10000000000000001***********111110011111**********************101
****************10000000000000001***************1001**************************101
****************10000000000000001111111111111111100111111111111111111111111111101
****************10000000000000000000000000000000000000000000000000000000000000001
****************10000000000000001111111111111111111111111111111111111111111111111
****************10000000000000001
****************10000000000000001
****************10000000000000001
****************10000000000000001
****************10000000000000001111111111111
****************10000000000000000000000000001
****************11111111111111111111111111111
