NO ./textures/purplestone.xpm
EA ./textures/redbrick.xpm

SO ./textures/mossy.xpm
WE ./textures/earth.xpm


F 19,168,15
C 66,135,245

1111111111111111111
1000000000000000001
1000000000000000001
1000000000000000001
1000000000000000001
1000000000000000001
1000000001000000001
1000000000000000001
1000000000000000001
1000000000000000001
1000000000000000001
1000000000000000001
1000000000101000001
1000000000101000001
1000000000000000001
1000000000000000001
1000000000000000001
100000000N000000001
1111111111111111111
